R 1280 800

EA assets/textures/ea.xpm

SO assets/textures/so.xpm

NO assets/textures/no.xpm

WE assets/textures/we.xpm

C assets/ceiling.xpm
F assets/floor.xpm


1111111111111111111111111111111111111111111111111111
1000000000000000000000000000000000000000000000000001
1000000000000000000000000000000000000000000000000001
1000000000000000000000000000000000000000000000000001
1000000000000000000000000000000000000000000000000001
1000000000000000000000000000000000000000000000000001
1000000000000000000000000000000000000000000000000001
1000000000000000000000000000000000000000000000000001
1000000000000000000000000000000000000000000000000001
1000000000000000000000000000000000000000000000000001
1000000000000000000000000000000000000000000000000001
1000000000000000000000000000000000000000000000000001
1000000000000000000000000000000000000000000000000001
1000000000000000000000000000000000000000000000000001
1000000000000000000000000000000000000000000000000001
1000000000000000000000000000000000000000000000000001
1111111111111111111111111111111111111000000000000001
                                    1000000000000001111111111111111111111111111111111111
                                    1000000000000000000000000000000000000000000000000001
                                    1000000000000000000000000000000000000000000000000001
                                    1000000000000000000000000000000000000000000000000001
                                    1000000000000000000000000000000000000000000000000001
                                    1000000000000000000000000000000000000000000000000001
                                    1000000000000000000000000000000000000000000000000001
                                    1000000000000000000000000000000000000000000000000001
                                    1000000000000000000000000000000000000000000000000001
                                    1000000000000000000000000000000000000000000000000001
                                    1000000000000000000000000000000000000000000000000001
                                    1000000000000000000000000000000000000000000000000001
                                    1000000000000000000000000000000000000000000000000001
                                    1000000000000000000000000000000000000000000000000001
                                    1000000000000000000000000000000000000000000000000001
                                    1000000000000000000000000000000000000000000000000001
                                    1111111111111111111111111111111111111111111111111111