NO src/assets/textures/wall.xpm
SO src/assets/textures/wall.xpm
WE src/assets/textures/wall.xpm
EA src/assets/textures/wall.xpm
F 220,100,0
C 225,30,0


1111111111111111111111111111111111111111111111111111
1000000000000000000000000000000000000000000000000001
1000000000000000000000000000000000000000000000000001
1000000000000000000000000000000000000000000000000001
1000000000000000000000000000000000000000000000000001
1000000000000000000000000000000000000000000000000001
1000000000000000000000000000000000000000000000000001
1000000000000000000000000000000000000000000000000001
1000000000000000000000000000000000000000000000000001
1000000000000000000000000000000000000000000000000001
1000000000000000000000000000000000000000000000000001
1000000000000000000000000000000000000000000000000001
1000000000000000000000000000000000000000000000000001
1000000000000000000000000000000000000000000000000001
1000000000000000000000000000000000000000000000000001
1000000000000000000000000000000000000000000000000001
11111111111111111111111111111111111110000000W0000001
                                    1000000000000001111111111111111111111111111111111111
                                    1000000000000000000000000000000000000000000000000001
                                    1000000000000000000000000000000000000000000000000001
                                    1000000000000000000000000000000000000000000000000001
                                    1000000000000000000000000000000000000000000000000001
                                    1000000000000000000000000000000000000000000000000001
                                    1000000000000000000000000000000000000000000000000001
                                    1000000000000000000000000000000000000000000000000001
                                    1000000000000000000000000000000000000000000000000001
                                    1000000000000000000000000000000000000000000000000001
                                    1000000000000000000000000000000000000000000000000001
                                    1000000000000000000000000000000000000000000000000001
                                    1000000000000000000000000000000000000000000000000001
                                    1000000000000000000000000000000000000000000000000001
                                    1000000000000000000000000000000000000000000000000001
                                    1000000000000000000000000000000000000000000000000001
                                    1111111111111111111111111111111111111111111111111111