NO src/assets/textures/wall.xpm
SO src/assets/textures/wall.xpm
WE src/assets/textures/wall.xpm
EA src/assets/textures/wall.xpm
F 220,10ghj0,0
C 225,30,0aed


1111111111111111111111111111111111111111111111111111
1000000000000000000000000000000000000000000000000001
1000000000000000000000000000000000000000000000000001
1000000000000000000000000000000000000000000000000001
1000000000000000000000000000000000000000000000000001
1000000000000000000000000000000000000000000000000001
1000000000000000000000000000000000000000000000000001
1000000000000000000000000000000000000000000000000001
1000000000000000000000000000000000000000000000000001
1000000000000000000000000000000000000000000000000001
1000000000000000000000000000000000000000000000000001
1000000000000000000000000000000000000000000000000001
1000000000000000000000000000000000000000000000000001
1000000000000000000000000000000000000000000000000001
1000000000000000000000000000000000000000000000000001
1000000000000000000000000000000000000000000000000001
11111111111111111111111111111111111110000000N0000001
                                    1000000000000001111111111111111111111111111111111111
                                    1000000000000000000000000000000000000000000000000001
                                    1000000000000000000000000000000000000000000000000001
                                    1000000000000000000000000000000000000000000000000001
                                    1000000000000000000000000000000000000000000000000001
                                    1000000000000000000000000000000000000000000000000001
                                    1000000000000000000000000000000000000000000000000001
                                    1000000000000000000000000000000000000000000000000001
                                    1000000000000000000000000000000000000000000000000001
                                    1000000000000000000000000000000000000000000000000001
                                    1000000000000000000000000000000000000000000000000001
                                    1000000000000000000000000000000000000000000000000001
                                    1000000000000000000000000000000000000000000000000001
                                    1000000000000000000000000000000000000000000000000001
                                    1000000000000000000000000000000000000000000000000001
                                    1000000000000000000000000000000000000000000000000001
                                    1111111111111111111111111111111111111111111111111111