NO src/assets/textures/wall1.xpm
SO src/assets/textures/wall2.xpm
WE src/assets/textures/wall3.xpm
EA src/assets/textures/wall4.xpm

F 220,100,0
C 225,30,200


1111111111111111111111111111111111111111111111111111                                                           1111111111111111111111111111111
1000000000000000000000000000000000000000000000000001                                                           1000000000000000000000000000001
1000000000000000000000000000000000000000000000000001                                                           1000000000000000000000000000001               1111111111111111111111111111111111111111111111111111111111
1000000000000000000000000000000000000000000000000001                                                           1000000000000000000000000000001               1000000000000000000000000000000000000000000000000000000001
1000000000000000000000000000000000000000000000000001                                                           1000000000000000000000000000001               1000000000000000000000000000000000000000000000000000000001   
1000000000000000000000000000000000000000000000000001                                                           10000000000000000000000000000011111111111111111000000000000000000000000000000000000000000000000000000001                
1000000000000000000000000000000000000000000000000001                                                           10000000000000000000000000000000000000000000000000000000000000000000000000000000000000000000000000000001
1000000000000000000000000000000000000000000000000001                                                           10000000000000000000000000000000000000000000000000000000000000000000000000000000000000000000000000000001
1000000000000000000000000000000000000000000000000001                                                           10000000000000000000000000000000000000000000000000000000000000000000000000000000000000000000000000000001
1000000000000000000000000000000000000000000000000001                                                           10000000000000000000000000000011111111111111111111111111111111000011111111111111111111111111111111111111
1000000000000000000000000000000000000000000000000001                                                           1000000000000000000000000000001                              100001
1000000000000000000000000000000000000000000000000001                                                           1000000000000000000000000000001                              100001
1000000000000000000000000000000000000000000000000001                                                           1000000000000000000000000000001                              100001
100000000000000000000000000000000000000W000000000001                                                           1000000000000000000000000000001                              100001     
1000000000000000000000000000000000000000000000000001                                                           1111111111111000111111111111111                              100001
1000000000000000000000000000000000000000000000000001                                                                       10001                                            100001
1111111111111111111111111111111111111000000000000001                                                                       10001                                            100001
                                    1000000000000001111111111111111111111111111111111111                                   10001                                            100001
                                    10000000000000000000000000000000000000000000000000011111111111111111111111111111111111110001                                            100001
                                    10000000000000000000000000000000000000000000000000000000000000000000000000000000000000000001                                            100001
                                    10000000000000000000000000000000000000000000000000000000000000000000000000000000000000000001                                            100001
                                    10000000000000000000000000000000000000000000000000000000000000000000000000000000000000000001                                            100001
                                    10000000000000000000000000000000000000000000000000000000000000000000000000000000000000000001                                            100001
                                    100000000000000000000000010000000000000000000000000111111111111111111111111111111111111100011111                                        100001
                                    1000000000000000000000000100000000000000000000000001                                   100000001                                        100001
                                    1000000000000000000000000100000000000000000000000001                                   100000001111111111        1111111111111111111111110000111111111111
                                    1000000000000000000000000100000000000000000000000001                                   100000000000000001        1000000000000000000000000000000000000001
                                    1000000000000000000000000100000000000000000000000001                                   100000000000000001        1000000000000000000000000000000000000001
                                    1000000000000000000000000100000000000000000000000001                                   100000000000000001        1000000000000000000000000000000000000001
                                    1000000000000000000000000100000000000000000000000001                                   100000000000000001        1000000000000000000000000000000000000001
                                    1000000000000000000000000000000000000000000000000001                                   100000000000000001        1000000000000000000100000000000000000001   1
                                    1000000000000000000000000000000000000000000000000001                                   100000000000000001111111111000000000000000000100000000000000000001
                                    1000000000000000000000000000000000000000000000000001                                   100000000000000000000000000000000000000000000100000000000000000001
                                    1111111111111111111111111111111111111111111111111111                                   100000000000000000000000000000000000000000000100000000000000000001
                                                                                                                           100000000000000000000000000000000000000000000100000000000000000001
                                                                                                                           111111111111111111111111111111111111111111111111111111111111111111