NO src/assets/textures/wall.xpm
SO src/assets/textures/wall.xpm
WE src/assets/textures/wall.xpm
EA src/assets/textures/wall.xpm

F 220,100,0
C 225,30,200

1111
1你1
1111
