NO ./src/assets/textures/wall.xpm
CE ./src/assets/textures/skybox_4096.xpm
WE ./src/assets/textures/wall.xpm
EA ./src/assets/textures/wall.xpm
SO ./src/assets/textures/wall.xpm

F 220,100,0
C 225,30,0
111111111111111111111111111111111111
111111111111111111111111111111111111
100000000000000000000000000000000001
100000000000000000000000000000000001
100000000000000000000000000000000001
100000000000000000000000000000000001
100000001111111111111111111111100001
100000001111111111111111111111100001
100000001000000000000000000000000001
100000001000000000000000000000000001
100000001000000000N00000000000000001
100000001000000000000000000000000001
100000001111111111111111111111100001
100000001111111111111111111111100001
100000000000000000000000000000000001
100000000000000000000000000000000001
100000000000000000000000000000000001
100000000000000000000000000000000001
100100000111100100100111100001100001
100100000111100100100111100001100001
100100000100100110100100001001100001
100100000100100110100100001001100001
100111100100100101100111111001100001
100111100100100101100111111001100001
100000000000000000000000000000000001
100000000000000000000000000000000001
100000000000000000000000000000000001
100000000000000000000000000000000001
111111111111111110011111111111111111
111111111111111110011111111111111111
100000000000000000000000000000000001
100000000000000000000000000000000001
100000000000000000000000000000000001
100000000000000000000000000000000001
100000001111111111111111111111100001
100000001111111111111111111111100001
100000001000000000000000000000000001
100000001000000000000000000000000001
100000001000000000000000000000000001
100000001000000000000000000000000001
100000001111111111111111111111100001
100000001111111111111111111111100001
100000000000000000000000000000000001
100000000000000000000000000000000001
100000000000000000000000000000000001
100000000000000000000000000000000001
100100000111100100100111100001100001
100100000111100100100111100001100001
100100000100100110100100001001100001
100100000100100110100100001001100001
100111100100100101100111111001100001
100111100100100101100111111001100001
100000000000000000000000000000000001
100000000000000000000000000000000001
100000000000000000000000000000000001
100000000000000000000000000000000001
111111111111111110011111111111111111
111111111111111110011111111111111111
100000000000000000000000000000000001
100000000000000000000000000000000001
100000000000000000000000000000000001
100000000000000000000000000000000001
100000001111111111111111111111100001
100000001111111111111111111111100001
100000001000000000000000000000000001
100000001000000000000000000000000001
100000001000000000000000000000000001
100000001000000000000000000000000001
100000001111111111111111111111100001
100000001111111111111111111111100001
100000000000000000000000000000000001
100000000000000000000000000000000001
100000000000000000000000000000000001
100000000000000000000000000000000001
100100000111100100100111100001100001
100100000111100100100111100001100001
100100000100100110100100001001100001
100100000100100110100100001001100001
100111100100100101100111111001100001
100111100100100101100111111001100001
100000000000000000000000000000000001
100000000000000000000000000000000001
100000000000000000000000000000000001
100000000000000000000000000000000001
111111111111111111111111111111111111
111111111111111111111111111111111111
